11111111111111111111
1000000000000000E001
1000P000000000000001
10000000000000000001
10000000000000000001
10000000000000000001
10000011111100000001
10000110000111100001
100C0C11000001110001
100C0110000001010001
10000011111111010001
10C00000000100110001
10C00000000111100001
10000000000000000001
10000000000000000001
10C00000000000000001
10000000000000000001
10CC000000000C000001
1CCCC000000000000001
11111111111111111111
