11111111111111
10000001000001
1000P0010C0001
1000E001000001
10000000000001
10000000000001
10000000000001
10000000000001
1000000C000001
11111111111111
