1111111111111111111111111111111111111111111111111111111111
10000000000000000C0000000000000000000000000000000000000001
1000000000000000000000000000000000000000000000000000000001
1000000000001111100000000000000000000000000000000000000001
1000000000000000000000000000000000000000000000000000000001
1000000000000000001110000000000000000000000000000000000001
1000000000000000000000000000000000000000000000000000000001
1000000000000000000000000000000000000000000000000000000001
1000000000000000000000000000000000000000000000000000000001
1000000000000000000000000000000000000000000000000000000001
1000P0000E000000000000000000000000000000000000000000000001
1111111111111111111111111111111111111111111111111111111111
