111111111111111111111111111111111111111111111111111111111
100000000000000000000000000000000000000000000000000000001
100000000000000000000000000000000000000000000000000000001
100000000000000000000000000000000000000000000000000000001
100000000000000000000000000000000000000000000000000000001
100000000000000000000000000000000000000000000000000000001
100000000000000000000000000000000000000000000000000000001
100000000000000000000000000000000000000000000000000000001
100000000000000000000000000000000000000000000000000000001
100000000000000000000000000000000000000000000000000000001
100000000000000000000000000000000000000000000000000000001
100000000000000000000000000000000000000000000000000000001
100000000000000000000000000000000000000000000000000000001
100000000000000000000000000000000000000000000000000000001
100000000000000000000000000000000000000000000000000000001
100000000000000000000000000000000000000000000000000000001
100000000000000000000000000000000000000000000000000000001
100000000000000000000000000000000000000000000000000000001
100000000000000000000000000000000000000000000000000000001
100000000000000000000000000000000000000000000000000000001
100000000000000000000000000000000000000000000000000000001
100000000000111110000000000000000000000000000000000000001
100000000000000000000000000000000000000000000000000000001
100000000000000000111000000000000000000000000000000000001
100000000000000000000001100000000000000000000000000000001
100000000000000000000000000010000000000000000000000000001
100000000000000000000000000100000000000000000000000000001
1000000000000000000E0000001000000000000000000000000000001
100000000000000CCC0P0CCC010000000000000000000000000000001
111111111111111111111111111111111111111111111111111111111
